16;119
1000000000000001
1000000000000001
1000000000000001
1000000010000001
1000000010000001
1000000010000001
1000000011000001
1000010000100001
1000000000000001
1000000000000001
1000100000000001
1000000000000001
1001000011000001
1000000000000001
1000000000000001
1001000000000001
1000001000100001
1000000000000001
1000000000100001
1000100000000001
1000100010000001
1000000000010001
1000000000000001
1000000100000001
1000100000000001
1000000000010001
1000001000000001
1000000000000101
1000000000010001
1000001000000001
1000000000000001
1000000010000101
1000000000000001
1000000000000001
1000100000000001
1000000000010001
1000000000000001
1000010000100001
1000000000000001
1000000100001001
1000000000000001
1000100000001001
1000001000000001
1000000010001001
1000100000001001
1000000000001001
1000000000001001
1000001000001001
1001000000001001
1000000000011001
1000000000001001
1000000000001001
1000000100001001
1000000000000001
1000000000000001
1000000000000001
1000000000000001
1000000000000001
1000000000000001
1000000010000001
1000000010000001
1000000010000001
1000000011000001
1000010000100001
1000000000000001
1000000000000001
1000100000000001
1000000000000001
1001000011000001
1000000000000001
1000000000000001
1001000000000001
1000001000100001
1000000000000001
1000000000100001
1000100000000001
1000100010000001
1000000000010001
1000000000000001
1000000100000001
1000100000000001
1000000000010001
1000001000000001
1000000000000101
1000000000010001
1000001000000001
1000000000000001
1000000010000101
1000000000000001
1000000000000001
1000100000000001
1000000000010001
1000000000000001
1000010000100001
1000000000000001
1000000100001001
1000000000000001
1000100000001001
1000001000000001
1000000010001001
1000100000001001
1000000000001001
1000000000001001
1000001000001001
1001000000001001
1000000000011001
1000000000001001
1000000000001001
1000010000001001
1000000000000001
1000000000000001
1000000000000001
1000000000000001
1000000000000001
1000000000000001
1000000000000001
1000000000000001
1000000000000001
1111111111111111