8;30
10000001
10001001
10011101
10001001
10010001
11000001
10000001
10000011
10001001
10001001
10001001
10001001
10001001
10000001
10000001
10100101
10000001
10010001
10000001
10000011
10000001
11000001
10001001
10001001
10000011
10000101
10000101
10000001
10000001
10000001
11111111